XXXXXXXXXXXXXX
XXXXXXXXXXXdXX
XXXXXXXXXXX XX
XXXXXXXXXXX XX
XXXXXXXXXXX XX
XXXXXXXXXX  XX
XXXXXXXXXX XXX
XX  bXXXXX  XX
X         kcXX
X A XXXXXXXXXX
X   XXXXXXXXXX
Xa  XXXXXXXXXX
XXXsXXXXXXXXXX
XXXXXXXXXXXXXX
