XXXXXXXXXXXX
X   bXXXXXXX
X    XXXXXXX
X  A      jX
X   XXXXXXXX
X  aXXXXXXXX
XcXXXXXXXXXX
XXXXXXXXXXXX
