XXXXXXXXXXXXXXXXX
XXXXXXXXXXXXdXXXX
XX        XX XXXX
XX       bXX XXXX
XX A         k cX
X    XXXXXXXXXXXX
Xa   XXXXXXXXXXXX
XXXXsXXXXXXXXXXXX
XXXXXXXXXXXXXXXXX
