XXXXXXXXXXXX
X          X
X          X
X          X
X   b      X
X a b A    X
X   b      X
X          X
X          X
X          X
X          X
XXXXXXXXXXXX
