XXXXXXXX
X      X
X   b  X
X a b AX
X   b  X
X      X
XXXXXXXX
