XXXXXXXXXXXXXXXXX
XXXXXXXXXXXXXXdXX
XX        XXXX XX
X        bXXXX XX
X  A         k cX
X    XXXXXXXXXXXX
Xa   XXXXXXXXXXXX
XXXXsXXXXXXXXXXXX
XXXXXXXXXXXXXXXXX
