XXXXXXXXXXXX
XXXbXXXXXXXX
XXX XXXXXXXX
X A      jpX
X XXXXXXXXXX
XbXXXXXXXXXX
XsXXXXXXXXXX
XXXXXXXXXXXX
