XXXXXXXXXXXXX
XXXXbXXXXXXXX
XXXX XXXXXXXX
XX A      jpX
XX XXXXXXXXXX
XXaXXXXXXXXXX
XcdXXXXXXXXXX
XXXXXXXXXXXXX
