XXXXXXXXXXXXX
XXXXXXXXXXXdX
XXXXXXXXXXX X
XXXXXXXXXXX X
XXXXXXXXXXX X
XXXXXXXXXX  X
XXXXXXXXXX XX
XX  bXXXXX XX
X         kcX
X A XXXXXXXXX
X   XXXXXXXXX
Xa  XXXXXXXXX
XXXsXXXXXXXXX
XXXXXXXXXXXXX
