XXXXXXXXXXXX
X  b a b A X
X  bb bb   X
X          X
XXXXXXXXXXXX
