XXXXXXXXXXXX
XXXXbXXXXXXX
XXXX XXXXXXX
X  A      jX
X   XXXXXXXX
X  aXXXXXXXX
XcXXXXXXXXXX
XXXXXXXXXXXX
